- Git-related
ğŸ”€	twisted_rightwards_arrows	Merging branches.
ğŸ‰	tada	Initial commit.
âª	rewind	Reverting changes.
- General
ğŸš§	construction	Work in progress.
ğŸ”§	wrench	Changing configuration files.
ğŸšš	truck	Moving or renaming files.
ğŸŒ	globe_with_meridians	Internationalization and localization.
ğŸ±	bento	Adding or updating assets.
âœï¸	pencil2	Fixing typos.
ğŸ“„	page_facing_up	Adding or updating license.
- Features
âœ¨	sparkles	Introducing new features.
ğŸ’„	lipstick	Updating the UI and style files.
ğŸ’©	hankey	Writing bad code that needs to be improved.
- Bugfixes
ğŸ›	bug	Fixing a bug.
ğŸš‘	ambulance	Critical hotfix.
ğŸ”’	lock	Fixing security issues.
ğŸ	apple	Fixing something on macOS.
ğŸ§	penguin	Fixing something on Linux.
ğŸ	checkered_flag	Fixing something on Windows.
ğŸš¨	rotating_light	Removing linter warnings.
- Dependencies
â•	heavy_plus_sign	Adding a dependency.
â–	heavy_minus_sign	Removing a dependency.
â¬‡ï¸	arrow_down	Downgrading dependencies.
â¬†ï¸	arrow_up	Upgrading dependencies.
ğŸ“ˆ	chart_with_upwards_trend	Adding analytics or tracking code.
ğŸ‘½	alien	Updating code due to external API changes.
- Refactoring
ğŸ¨	art	Improving structure / format of the code.
âš¡ï¸	zap	Improving performance.
ğŸ”¥	fire	Removing code or files.
ğŸ”¨	hammer	Heavy refactoring.
- Integration
ğŸ”–	bookmark	Releasing / Version tags.
ğŸš€	rocket	Deploying stuff.
ğŸ“	memo	Writing docs.
ğŸ‘·	construction_worker	Adding CI build system.
ğŸ’š	green_heart	Fixing CI Build.
ğŸ³	whale	Work about Docker.
ğŸ“¦	package	Updating compiled files or packages.
- Testing
âœ…	white_check_mark	Adding tests.
